"filename", "language", "TypeScript", "comment", "blank", "total"
"c:\Users\QIANG\dev\sktest\src\pathops\sk-add-intersections.ts", "TypeScript", 5, 2, 0, 7
"c:\Users\QIANG\dev\sktest\src\pathops\sk-intersections.ts", "TypeScript", 5, 0, 0, 5
"c:\Users\QIANG\dev\sktest\src\pathops\skop-angle.ts", "TypeScript", 1, 0, 0, 1
"c:\Users\QIANG\dev\sktest\src\pathops\skop-segment.ts", "TypeScript", 0, 2, -1, 1
"c:\Users\QIANG\dev\sktest\src\pathops\skpath-ops-conic.ts", "TypeScript", 117, 32, 53, 202
"c:\Users\QIANG\dev\sktest\src\pathops\skpath-ops-line.ts", "TypeScript", 27, 5, 13, 45
"c:\Users\QIANG\dev\sktest\src\pathops\skpath-ops-point.ts", "TypeScript", 1, 0, 0, 1
"c:\Users\QIANG\dev\sktest\src\pathops\skpath-ops-rect.ts", "TypeScript", 1, 0, -1, 0
"c:\Users\QIANG\dev\sktest\src\pathops\skpath-ops-t-curve.ts", "TypeScript", 23, 12, 2, 37
"c:\Users\QIANG\dev\sktest\src\pathops\skpath-ref.ts", "TypeScript", 1, 0, 1, 2
"Total", "-", 181, 53, 67, 301